Lane,SampleID,Index,# Reads,# Perfect Index Reads,# One Mismatch Index Reads,# of >= Q30 Bases (PF),Mean Quality Score (PF)
1,TCGA-GU-A766-01A-11D-A32B-08,CCGCGGTT-AGCGCTAG,164309338,160074550,4234788,45416310813,35.52
1,TCGA-GU-A767-01A-11D-A32B-08,AGTTCAGG-CCAACAGA,124254681,120369013,3885668,34285189337,35.49
1,TCGA-FD-A6TF-01A-52D-A32B-08,TAATACAG-ATATTCAC,137266587,132966067,4300520,37981133897,35.53
1,TCGA-ZF-AA4T-01A-11D-A38G-08,TTATAACC-GATATCGA,119627217,115972055,3655162,32989336620,35.47
1,TCGA-ZF-A9RE-01A-11D-A38G-08,GACCTGAA-TTGGTGAG,97865107,94600430,3264677,26968975598,35.47
1,TCGA-ZF-AA4W-01A-12D-A38G-08,CGGCGTGA-GCGCCTGT,84542860,82273403,2269457,23344243794,35.51
1,TCGA-E7-A97P-01A-11D-A38G-08,ATCCACTG-AGGTGCGT,110600468,107513883,3086585,30572291846,35.52
1,TCGA-ZF-A9R7-01A-11D-A38G-08,GGACTTGG-CGCAGACG,165028983,160656208,4372775,45803769649,35.59
1,TCGA-XF-A8HI-01A-11D-A38G-08,TCTCTACT-CGCGGTTC,87496591,85130169,2366422,23962776360,35.35
1,TCGA-UY-A9PB-01A-11D-A38G-08,ATGTAAGT-ACTCTATG,108172142,104337217,3834925,29755025954,35.44
1,TCGA-UY-A78K-01A-11D-A339-08,AAGTCCAA-TATGAGTA,156777889,152322215,4455674,43368386836,35.53
1,TCGA-KQ-A41Q-01A-11D-A339-08,CTCTCGTC-TATAACCT,117501928,113441340,4060588,32608752129,35.59
1,TCGA-FD-A6TA-01A-12D-A339-08,GCACGGAC-GTCTCGCA,91042004,88472140,2569864,25095912525,35.47
1,TCGA-GU-A762-01A-11D-A339-08,CCAAGTCT-AAGGATGA,117421873,113932956,3488917,32396113124,35.48
1,TCGA-DK-A6AW-01A-11D-A30E-08,GGTACCTT-AAGACGTC,188089502,181962894,6126608,51919942852,35.49
1,TCGA-GU-A764-01A-11D-A34U-08,GCTTGTCA-GAACATAC,98882365,95658370,3223995,27305119813,35.50
1,TCGA-GV-A3JX-01A-11D-A20D-08,TTGGACTC-GGAAGCAG,118955778,115392813,3562965,32956378824,35.56
1,TCGA-FJ-A3ZF-01A-11D-A23M-08,AACGTTCC-GGAGTACT,86146055,83188036,2958019,23891758585,35.58
1,TCGA-FJ-A871-01A-11D-A34U-08,CAAGCTAG-ACATAGCG,135210767,130922881,4287886,37359864224,35.51
1,TCGA-FD-A5BT-01A-11D-A26M-08,GGCTTAAG-TCGTGACC,135042560,130935586,4106974,37071004950,35.39
1,TCGA-E7-A5KE-01A-11D-A289-08,GCAGAATT-ACCGGCCA,114278499,110662126,3616373,31397266612,35.39
1,TCGA-DK-A6B1-01A-12D-A30E-08,TGGATCGA-GTGCGATA,134034402,130628016,3406386,37056219303,35.52
1,TCGA-CU-A5W6-01A-11D-A289-08,AATCCGGA-CTACAGTT,102137660,99090900,3046760,27608309582,35.13
1,TCGA-E7-A7DU-01A-11D-A32B-08,ATGAGGCC-GTTAATTG,112395061,108834385,3560676,30950703728,35.45
1,Undetermined,Undetermined,130934415,130934415,0,31678372147,33.11
2,TCGA-CF-A9FH-01A-11D-A38G-08,CAATTAAC-CGAGATAT,109371278,106481964,2889314,30315205335,35.57
2,TCGA-4Z-AA7S-01A-11D-A391-08,AACTGTAG-ACGCCGCA,127739952,123894852,3845100,35463070038,35.59
2,TCGA-ZF-A9RL-01A-11D-A38G-08,TATCGCAC-CTTAGTGT,130528667,127293241,3235426,36231009675,35.59
2,TCGA-UY-A9PA-01A-11D-A38G-08,TGGCCGGT-TAGAGCGC,110742848,108089024,2653824,30485438714,35.45
2,TCGA-ZF-AA4X-01A-11D-A38G-08,CGCTATGT-TCCGACAC,105859167,102773932,3085235,29202391032,35.48
2,TCGA-UY-A9PD-01A-11D-A38G-08,AGTACTCC-AACCTGTT,95168740,91642614,3526126,26347667566,35.55
2,TCGA-K4-AAQO-01A-11D-A38G-08,CTGCTTCC-GATAGATC,89571233,86025708,3545525,24806037273,35.56
2,TCGA-S5-AA26-01A-11D-A38G-08,GTATGTTC-AACAGGAA,161866602,157612039,4254563,44902725993,35.58
2,TCGA-GV-A6ZA-01A-12D-A339-08,CTAGCGCT-GTGTAGAC,172788519,168039478,4749041,47574456141,35.44
2,TCGA-FD-A6TK-01A-42D-A339-08,GACGTCTT-GGTTCACC,182961469,177349422,5612047,50690254868,35.57
2,TCGA-KQ-A41S-01A-12D-A339-08,TCATCCTT-AGCGAGCT,124233758,120733468,3500290,34422605611,35.56
2,TCGA-FD-A6TE-01A-12D-A339-08,ACGCACCT-GGTGAAGG,122272448,119042141,3230307,33684598082,35.47
2,TCGA-UY-A78O-01A-12D-A339-08,GGTCACGA-GTATTATG,106198562,102340726,3857836,29341837060,35.51
2,TCGA-GV-A3QK-01B-11D-A23M-08,TGCGAGAC-CATTGTTG,100693175,97382922,3310253,27818288055,35.52
2,TCGA-GD-A3OS-01A-12D-A21Z-08,AGGTTATA-CAGTTCCG,87469893,84460679,3009214,24137835720,35.50
2,TCGA-K4-A83P-01A-11D-A34U-08,TACTCATA-CCTGTGGC,85775437,83428875,2346562,23589383729,35.44
2,TCGA-LT-A8JT-01A-11D-A364-08,CATAGAGT-TGCCACCA,130298109,126099395,4198714,36008355949,35.52
2,TCGA-XF-A8HE-01A-11D-A364-08,GAACCGCG-TGACCTTA,100107763,96205890,3901873,27655184442,35.52
2,TCGA-FJ-A3Z9-01A-11D-A26M-08,CGTCTGCG-TTCACAAT,83477274,80723653,2753621,22996732012,35.47
2,TCGA-FD-A5BR-01A-11D-A26M-08,ACAGGCGC-CTCTGCCT,155006252,150465998,4540254,42829403878,35.52
2,TCGA-E7-A519-01A-11D-A26M-08,CTCACCAA-CTAGGCAA,114611978,111099597,3512381,31510068102,35.43
2,TCGA-FD-A5BS-01A-21D-A26M-08,TCGATATC-ACACGAGT,119940158,116383844,3556314,33211003371,35.55
2,TCGA-DK-A6AV-01A-12D-A30E-08,GTGAATAT-TCTCATTC,139232720,135011315,4221405,38652229130,35.60
2,TCGA-E7-A678-01A-11D-A30E-08,TCTGTTGG-TCGAATGG,142513437,138301389,4212048,39415367114,35.53
2,Undetermined,Undetermined,175734569,175734569,0,43573155934,33.53
3,TCGA-SY-A9G0-01A-12D-A38G-08,ATATCTCG-ATCTTAGT,105797415,102205905,3591510,29302439978,35.55
3,TCGA-ZF-AA4U-01A-11D-A38G-08,TGCGGCGT-CCTCGGTA,163373657,159604640,3769017,45126385249,35.51
3,TCGA-ZF-A9RF-01A-11D-A38G-08,ACACTAAG-ATCCATAT,118573497,114617500,3955997,32709575431,35.48
3,TCGA-2F-A9KR-01A-11D-A38G-08,GCGCTCTA-GCTCCGAC,102073254,99539207,2534047,28200711465,35.51
3,TCGA-ZF-A9RM-01A-11D-A38G-08,CATAATAC-TTCTAACG,91670235,89035891,2634344,25440064035,35.59
3,TCGA-XF-A8HH-01A-11D-A38G-08,GTGTCGGA-GCTTGCGC,112435583,109603843,2831740,30815416661,35.37
3,TCGA-ZF-AA4N-01A-11D-A38G-08,AACAGGTT-ATACCAAG,136889981,132822163,4067818,37799252965,35.50
3,TCGA-ZF-A9R9-01A-11D-A38G-08,GATCTATC-ATGAGGCT,97144989,93749702,3395287,26905559726,35.55
3,TCGA-YC-A8S6-01A-31D-A38G-08,TTCCTGTT-AGTATCTT,172809679,167440206,5369473,47549589113,35.43
3,TCGA-E7-A7DV-01A-11D-A339-08,AGCTCGCT-GCAGAATC,146038992,139475278,6563714,40165191179,35.42
3,TCGA-FD-A6TB-01A-12D-A339-08,CCTTCACC-GACGCTCC,117246843,113390065,3856778,32368560262,35.50
3,TCGA-YC-A89H-01A-11D-A364-08,CAACAATG-CTTCACGG,105894851,103055097,2839754,29362217192,35.57
3,TCGA-UY-A8OC-01A-11D-A364-08,CGGAACTG-CACTACGA,88659483,85596588,3062895,24541970658,35.54
3,TCGA-XF-A8HG-01A-11D-A364-08,GCCACAGG-CATGCCAT,108891474,105081229,3810245,30000898701,35.46
3,TCGA-GV-A3JV-01A-11D-A21Z-08,TGGTGGCA-TCCTGTAA,111567223,108747359,2819864,30598024094,35.38
3,TCGA-DK-A3WW-01A-22D-A23M-08,TAAGGTCA-TGTCGTAG,132532133,129086529,3445604,36613313335,35.51
3,TCGA-GV-A3JZ-01A-11D-A21A-08,ATTGTGAA-TGCATTGC,139629880,136350192,3279688,38391013180,35.42
3,TCGA-E7-A677-01A-11D-A30E-08,AGGCAGAG-AGAATGCC,142742028,84517840,58224188,39314493595,35.45
3,TCGA-FD-A62S-01A-11D-A30E-08,TTGCCTAG-ACCACTTA,129937426,126100073,3837353,35779835371,35.45
3,TCGA-FD-A5BV-01A-11D-A26M-08,ACTCGTGT-ATTGGAAC,161992243,158117126,3875117,44751931208,35.51
3,TCGA-KQ-A41O-01A-12D-A34U-08,GAATGAGA-GAGGCATT,158917156,153166671,5750485,43897476724,35.51
3,TCGA-E7-A7XN-01A-11D-A34U-08,CCATTCGA-GTTGTCCG,128669289,125038990,3630299,35644159385,35.56
3,TCGA-E7-A7PW-01A-11D-A34U-08,GTCTACAC-GCCAAGGT,163713176,159317566,4395610,45041165542,35.44
3,Undetermined,Undetermined,143221849,143221849,0,35092386003,33.31
4,TCGA-FD-A6TG-01A-11D-A32B-08,ACTAAGAT-AACCGCGG,153275681,145911563,7364118,42845143096,35.70
4,TCGA-FD-A6TH-01A-11D-A32B-08,TACCGAGG-CCTGAACT,113985432,110998558,2986874,31854967960,35.70
4,TCGA-G2-AA3D-01A-11D-A391-08,ATATGGAT-CTGTATTA,135233145,131611662,3621483,37813022262,35.72
4,TCGA-ZF-A9R4-01A-11D-A38G-08,GTCGGAGC-GGTTATAA,139300049,133578145,5721904,38900963362,35.69
4,TCGA-SY-A9G5-01A-11D-A38G-08,CGTTAGAA-TTCAGGTC,87806995,85647901,2159094,24519398259,35.69
4,TCGA-CF-A9FM-01A-11D-A38G-08,GCGCAAGC-TCACGCCG,81280650,79197789,2082861,22611820728,35.62
4,TCGA-E7-A97Q-01A-11D-A38G-08,CTTGGTAT-CCAAGTCC,144061132,140020257,4040875,40178981222,35.67
4,TCGA-2F-A9KW-01A-11D-A38G-08,AGCCTCAT-AGTAGAGA,131028652,127478518,3550134,36610233449,35.70
4,TCGA-CF-A9FF-01A-11D-A38G-08,AAGATACT-ACTTACAT,104924069,101811815,3112254,29298263551,35.69
4,TCGA-FD-A6TD-01A-51D-A339-08,TCCAACGC-TTGGACTT,165569678,160804152,4765526,46201829635,35.68
4,TCGA-UY-A78N-01A-12D-A339-08,GATTCTGC-GACGAGAG,102438781,99503290,2935491,28657606093,35.72
4,TCGA-KQ-A41N-01A-11D-A339-08,GGAGCGTC-GTCCGTGC,107717129,104949010,2768119,30111355596,35.71
4,TCGA-XF-A8HD-01A-11D-A364-08,CCGTGAAG-CAGTGGAT,120390231,116828827,3561404,33611915906,35.68
4,TCGA-E7-A8O7-01A-11D-A364-08,TCGTAGTG-AGACTTGG,83483454,80935849,2547605,23269793749,35.66
4,TCGA-E7-A8O8-01A-11D-A364-08,ATGGCATG-AAGGTACC,179480440,173798307,5682133,49624655611,35.52
4,TCGA-GC-A3YS-01A-11D-A23M-08,TTACAGGA-TGACAAGC,96339898,93200630,3139268,26632726042,35.51
4,TCGA-GC-A3RB-01A-12D-A21Z-08,CTACGACA-GAGTCCAA,121666524,118365984,3300540,33928445738,35.67
4,TCGA-HQ-A2OE-01A-11D-A202-08,GCAATGCA-GGAACGTT,107809314,104745375,3063939,30033825438,35.65
4,TCGA-FD-A43Y-01A-21D-A26M-08,GGCATTCT-CTAGCTTG,102876061,99767657,3108404,28436098955,35.52
4,TCGA-DK-A6B0-01A-11D-A31L-08,TAAGTGGT-CTTAAGCC,133201341,129557226,3644115,37102314003,35.65
4,TCGA-K4-A5RH-01A-11D-A30E-08,GTTCCAAT-AATTCTGC,138655777,134937495,3718282,38685713882,35.67
4,TCGA-FT-A61P-01A-11D-A30E-08,AATGCCTC-TCGATCCA,177495307,172264929,5230378,49720952501,35.75
4,TCGA-UY-A78M-01A-21D-A34U-08,CGGACAAC-TCCGGATT,113960796,110628826,3331970,31846073754,35.70
4,TCGA-E7-A85H-01A-11D-A34U-08,ACCTTGGC-GGCCTCAT,144149950,140057122,4092828,40038816096,35.60
4,Undetermined,Undetermined,122561763,122561763,0,29877451787,33.21